미친맛집: 미식가 친구의 맛집 8화 "중독된 사랑" 평양냉면
Subtitle	Human Translation
ミッチョッタ(やばい) ミッチョッタ	[마츠시게] 미쳤다, 미쳤다
ここですね あの… 忠武路(チュンムロ)筆洞(ピルトン) “筆洞麺屋(ピルトンミョノク)”	- [일본어] - [마츠시게] 응
“筆洞麺屋(ピルトンミョノク)” 筆洞という 場所なんですけど	- [시경] 필동이란 곳인데요 - [마츠시게] 응
後ろ Ｎタワーが 見えますよね	[마츠시게] 응
最近じゃないんだ この間 名前変えて	최근은 아니지만
今は“Ｎタワー”	[마츠시게] 응
Ｎタワー？ へえ ソウルタワー	- [시경] - [마츠시게] 그래?
その丸い あれが 回るんですよ	[마츠시게] 응
ああ	[마츠시게] 와…
寂しいこと言わないで 付き合ってあげるよ じゃあ	- [익살스러운 음악] - [마츠시게]
あっ ほんとですか？	- [시경] - 응
お父さん お母さんが デートしてた時	[마츠시게] 응
通ってた お店	[마츠시게] 엇?
子供も みんな好き	[마츠시게] 응
冷たいスープだから “真夏に⸺”	- [시경] - [마츠시게] 응
“ふさわしいんじゃ ない？”っていう…	[마츠시게] 응
なんか かっこいいね ここね はい	- [마츠시게] - [시경] 네
入ってみますか はい どうぞ	- 들어가 볼까? 그래 - 네, 가시죠
アンニョンハセヨ	- [한국어] - [점원] 지금 2층!
アンニョンハセヨ	[시경] 네
ああ	아…
最初 その 豚肉と蒸し餃子(マンドゥ) 最初 その 豚肉と蒸し餃子(マンドゥ) “豚肉 ３万ウォン” “豚肉 ３万ウォン” “豚肉 ３万ウォン” うん 食べて話してから 注文しましょう “皿盛り蒸し餃子 １万５０００ウォン”	- [시경] - [마츠시게] 응, 응
“皿盛り蒸し餃子 １万５０００ウォン” “皿盛り蒸し餃子 １万５０００ウォン” ええ いきましょう	[마츠시게] 그러자
豚肉(チェユク)１つと はい	- [시경/한국어] - [점원] 네
ここは いらないですよね？ 焼酎でいいですよ 焼酎で	- 여긴 필요 없죠? - [마츠시게]
ええ？ はい	- [시경] 그래요? 네 - [마츠시게] 그래, 소주
いらっしゃいませ	- [마츠시게/일본어] 고마워요 - [점원/한국어] 반가워요
アンニョンハセヨ	[시경] 네
どうぞ	[점원] 네
へえ	[일본어] 와
おっ これ何ですか？ これは	- [마츠시게] - [점원/한국어] 면수 드릴게요
よかった 寒いんで飲みましょう	[마츠시게] 우선 마시자
どうも	고마워
ここ 来てて はい	[시경] 네
はい そして⸺	[시경] 그리고
昔は持ち主の おじいさんが	[마츠시게] 응, 응
いつも いつも 一番 奥の席で	- [시경] - [마츠시게] 응
並んでても座って こう 新聞を見てたんですよ	[마츠시게] 계셨어?
へえ	그래?
具なしで 麺大盛り	[마츠시게] 응
ああ	아…
“こんにちは”と同じく	- [시경] - 그래
まあ40年 50年前だったんで	아아, 그래
ああ	아아…
肉 卵なしで 麺だけ大盛りで	[마츠시게] 응
ここがメインで 僕は	[시경] 네
どうしようもなく	[마츠시게] 응
うん	[마츠시게] 응
ここで入門したら	- [시경] - [마츠시게] 응
なんか これが おいしくなるっていう	- [시경] - [마츠시게] 응 [마츠시게] 응
で あの… 平壌冷麺なんだけど	[마츠시게] 응
ほんとに申し訳ないけど 冷麺って	[시경] 네
焼肉屋さんで 最後にシメで	[시경] 마무리
“クッパにする？ 冷麺にする？”っていう	[시경] 네, 네
スープが違うの？	[시경] 오늘…
で あの… 肉のだしと たぶん⸺	[마츠시게] 응
スープを作ると 聞きました	응, 그렇구나
いいお店っていくらでも あるんですけど “いや どうしても ここだな”と思って	[마츠시게] 응
へえ	- [마츠시게] 그래? - [시경] 그게…
初体験が大事 だから まっちげさんを	[마츠시게] 그래
すごいね	[시경] 네
犬みたいに	[마츠시게] 개처럼
そうでしょ	- [제작진들의 웃음] - 그래
どうも	- [시경/한국어] 감사합니다 - [점원] 네
これ何ですか？ これは	- [일본어] - [점원/한국어] 네
これがチェユクです	- [시경/일본어] - 제육
ああ	아아…
ポッサムと 同じ感覚なんですけど ゆでて⸺ それに なんか重いもの のっけて こう… そうすると脂も抜けるし	- [마츠시게] 그래 - [시경]
なんか もっと 弾力ができる？	[마츠시게] 그래
ああ	아…
じゃ これにつけて 食べるんですけど好みで	[마츠시게] 그래
はい	[시경] 네
ヤンニョムが出て くるよね こうやってね	- 이렇게 - [시경]
僕もね あの… 東京で 日本でポッサム	- [마츠시게] - [시경] 네
はい	네
うん だから好きです	[마츠시게] 응
いただきます	[시경] 괜찮네요
うん	[마츠시게] 음
もっと凝縮されるって いうんですよ	[마츠시게] 응
圧力をかして 長い間 置いておくと	[마츠시게] 응
うまみも 味も もっと⸺	[마츠시게] 응
増える？ 上がる？	[마츠시게] 응
えっ？	아…
うん	음
どう？ うん	- [일본어] - [시경] 음
いけてない？ これ	- [마츠시게] - [시경] 네
うんうん	[마츠시게] 응
ふうん	그렇구나
うん	음
あっさりしてるけど	네
だから これじゃ ダブっちゃうから	- [시경] - [마츠시게] 어? 응
うん	[마츠시게] 맞아
で 普通 こうやって うんうんうん	- [시경] - [마츠시게] 응, 응, 응
こう巻いて うん	- [시경] - [마츠시게] 그래
うん	[마츠시게] 음
ああ	카아
マンドゥ	[시경] 만두
うん	- 음 - [시경] 정말 좋아요
うん	[시경] 음
うん うん	- [마츠시게] 음 - [시경] 음
うん	[마츠시게] 그래
酢がらし 教えてもらったんで	[마츠시게] 응 [마츠시게] 응
僕は マンドゥを これぐらい残して	- [시경] - [마츠시게] 응 [마츠시게] 응
これと一緒に食べると	[마츠시게] 같이 먹는구나
また おいしいんですよ	[마츠시게] 오!
うん	음
うん	[시경] 음!
うん うん	[마츠시게] 음, 음!
うん	음!
うまい	맛있어
うん	응
ああ	아!
もうマンドゥには 酢がらし	- 허! - [익살스러운 음악]
バイ 松重豊	[마츠시게] 그래 - [시경] - [마츠시게] 마츠시게 유타카, 응
うん	- [시경] - [마츠시게] 마츠시게 유타카, 응
おお	오!
だめだよ	[마츠시게] 안 되지
マンドゥを よく召し上がる	- [시경/한국어] - [제작진] 그러니까요
大丈夫ですか？ マンドゥ	- [시경/일본어] - [마츠시게] 응?
俺は なんか今日 食べてるよ	[시경] 이…
冷麺に集中しないと 伸びるし	[마츠시게] 아, 집중하는구나
ああ	- 아아… - [시경] 그렇죠
あの ２種類 あるんですけど	[마츠시게] 그래
僕のお薦めは “ムルレンミョン”	[마츠시게] 응
うん 水冷麺	[마츠시게] 그래
すみません	- [시경/한국어] 저기요! - [마츠시게/일본어]
スープが おいしいって 聞いたら…	- [시경/한국어] 저기요! - [마츠시게/일본어] [점원/한국어] 네
水冷麺２つ “冷麺 １万５０００ウォン”	- [시경] 물냉면 두 개 주세요 - [점원] 예
よだれが止まらない	아, 침이 계속 나와가지고 나 이거 진짜…
よだれが…	- [일본어] - [마츠시게] 왜?
よだれが出てる？	- [제작진들의 웃음] - [시경] 네, 이거…
うん この…	[마츠시게] 그래
あの… 僕 昔 軍隊に入って	[마츠시게] 응
ああ	아…
えっ？ 冷麺のスープって	엇?
いやあ 楽しみ楽しみ	[마츠시게] 이, 이게…
はい	[시경] 네
おお	오오…
お酢 入れて⸺	[시경] 네
うん 焼肉屋さんのシメの 冷麺が なんか⸺	- [마츠시게] 응 - [시경]
うん	[마츠시게] 응
ああ	- 아… - [시경] 그렇죠
あの… 冷麺 来る前に	[마츠시게] 응
ああ 最初？ うん	[시경] 네
あっ 来た	[점원/한국어] 나왔습니다, 네
肉のだしと たぶん “トンチミ”っていう スープを混ぜて⸺	- [시경/일본어] - [마츠시게] 응, 응
スープを作ると 聞きました	[마츠시게] 응, 와…
これ見た目が また全然 違うなあ	[시경] 그게… 네
このままでも いいんですけど	- [시경] - [마츠시게] 응
これ こうやって 飲んでいいの？ ああ そう	- [시경] 네, 숟가락… - 그렇구나
ああ	아…
ああ	와…
では麺を ちゃんとほぐして うん	- [시경] - [마츠시게] 응
はい	[시경] 네
で こうやって	[마츠시게] 응
へえ	[시경] 네
うん	[마츠시게] 음
うん	[마츠시게] 음…
風味	[마츠시게] 그렇지?
あるシェフが言いました 普通⸺	[마츠시게] 응
“ああ甘い” “辛い” “しょっぱい”	[마츠시게] 응
で これは⸺	[마츠시게] 응
食べるようになる 食べ物だから	[마츠시게] 응
うん	[마츠시게] 그래
うん	[시경] 네
“うん？”	[마츠시게] 응
徐々にね	[마츠시게] 서서히
“初体験” “面白い”	그래
“奥深い” “よく分かんない”	[마츠시게] 응
うん	[마츠시게] 응
これ麻薬みたいな 存在です これ ほんとに	[마츠시게] 응
うん	그래
へえ	[시경] 우와
うん	[마츠시게] 음
海のほう 南の海のほうだから	[마츠시게] 그래 [마츠시게] 응
ああ スープが違う？	- [시경] - 오…
咸興も 北朝鮮なんですけど	[마츠시게] 그래
ジャガイモの でんぷんを入れて	- [시경] - [마츠시게] 오오
へえ	[마츠시게] 와…
平壌冷麺ですよね	그래, 응
これ 一味を 粉唐辛子(コチュカル)を ちょっと うん	- [시경] - [마츠시게] 이거야? 응
うん	[마츠시게] 음
おお すごい詩的な…	[마츠시게] 응
ああ 第２弾の変化は	- [마츠시게] 와 - [시경]
うん この ゆで卵の 卵黄を潰すと	- [마츠시게] 응, 응 - [시경]
うん	[마츠시게] 응
スープが全部 汚れちゃうんで	[마츠시게] 탁해져?
そうだね うん	- [마츠시게] - 네
ふうん うれしい	- [시경] - [마츠시게] 응
いや だめです	[마츠시게] 아니야?
って言えるわけ ないでしょう どうぞ どうぞ	- [시경] - [마츠시게] 그래, 넣어도 돼?
それ 好みですからね	- [시경] - [마츠시게] 그래
へえ	[시경] 오…
うん マンドゥを 僕より多く食べたのに	- 음 - [시경/한국어]
ええ？	[시경] 오…
全部 食べますよ	[마츠시게] 응
今 おいくつ？ お父さん お母さん	[시경] 네
あの…	[시경] 그게…
うん もう80だ	[마츠시게] 그래
うん	[마츠시게] 그래
はい	[시경] 네
気づいたのは 僕 日本で	[마츠시게] 응
うん	[마츠시게] 맞아
そのまま与えられた味を 受け入れるんじゃなく	[마츠시게] 응
“こうしてみようか？” なんか いつも…	[마츠시게] 응
それを グルメだと思います でも いわゆる グルメって言っても	[마츠시게] 응
要するに⸺	[시경] 네
どんどん どんどん行く	네
シギョンちゃん 子供の頃から	네
本当に おいしいもの 食べた時の…	[시경] 아… 이야
それが記憶になるし うん	- [마츠시게] 응 - 오오
うん	[시경] 네
すみません はい ピサリを１つ	- [시경/한국어] - [점원] 네
はい 何？ “ピザリヤ”って	- [점원] 네 - [마츠시게/일본어]
混ぜ冷麺(ピビンネンミョン)の あの… 替え玉？	[마츠시게] 응
ふうん	오…
うんうんうん	[마츠시게] 응
肉とか卵とか ない 麺だけを	[마츠시게] 응, 응
追加できるんですよ	[마츠시게] 오오…
うん	[마츠시게] 음
ほんとですか？	[마츠시게] 음
どうも	- [시경/한국어] - [점원] 네
ごま油が いっぱい入ってて おお	- [시경/일본어] - [마츠시게] 오…
うん ちょっと もらおうかな	[마츠시게] 그럴까?
ああ	와…
初心者は このピビンを よく頼むんです	[마츠시게] 응
うん	[마츠시게] 그래
うん	[시경] 음
巻きたくなっちゃう 韓国人は	[마츠시게] 응 아이고
好きだね 巻くの	- [마츠시게] - [시경] 네
あっ	[마츠시게] 엇
うん	[시경, 마츠시게] 음
うん	- [시경] 네 - 그래
初めて聞いた	[마츠시게] 응
体の中から消化酵素が ブワッと出てきて	[시경] 아…
こう…	[마츠시게] 이렇게
冷麺 これは東京じゃ 日本じゃ食えないね	[시경] 네
死ぬまで食べたい 飲みたいスープ	[마츠시게] 먹고 싶어?
なんか もういずれさ ２人でさ	[시경] 네
知らないとこ ドライブしながら	[시경] 네
うん	[마츠시게] 응
やってらっしゃる そうですよ	- [마츠시게] 하고 싶어, 맞아 - [제작진들의 웃음]
いやあ 始まったばっかりなのに	엇
いやあ ありがたいですよ	와 [마츠시게] 기준이 높아지고 있어
もう 明日…	[시경] 그게…
ホドゥクァジャだ デザート天国の薬水(ヤクス)市場	[마츠시게/한국어] 호두과자다