미친맛집: 미식가 친구의 맛집 5화 해질녘 후지산과 환상적인 푸딩
Subtitle	Human Translation
グルメな友達のグルメ店 「隣の国のグルメイト」	- [경쾌한 음악] - [시경]
ミッチョッタ(やばい) ミッチョッタ	[마츠시게] 미쳤다, 미쳤다
見えなさそう	[마츠시게] 응
どうも はい	[마츠시게] 네
じゃあ 行きましょうか	- [시경] 들어가세요 - [마츠시게]
あっ ほら すごい	- [마츠시게] - [점원] 어서 오세요
デートみたいな もんですよ ねえ	그렇죠?
してきたんじゃ ないですか 今日	[시경] 배경 음악도요
正装して	정장 입고요, 정장 입고…
入った瞬間	- [시경] - [제작진의 웃음]
デートコースじゃ ないですか ここ まっちげのデザート巡り	[시경] 여기 데이트 코스네요
まっちげのデザート巡り チーズケーキが おいしいんですよ	[마츠시게] 치즈케이크가 맛있어요
ここね	- [마츠시게] - [시경] 네
秋谷？	[시경] 아키야
そこ 昔よく 釣りに来てたんですよ	- [마츠시게] - [시경의 호응]
おっきい富士山 見えるでしょ？	[마츠시게] 네?
いや 見えそうで 見えなさそうで…	[시경] 아뇨 보일 듯 안 보일 듯해요
はい	네
僕の恋愛関係ですよ これからの僕の恋愛関係	[마츠시게] 맑을 거예요
ええ	[마츠시게] 네
非常においしい	[마츠시게] 네
転換が速い	[마츠시게] 그리고
プリン店に カニのパスタ？ カニみそパスタ？	게 내장 파스타?
身が こうソースの中に	[시경] 그렇죠?
わあ この時間 やってない	와…
プリン	[시경] 푸딩 시간?
デザート天国	- [시경] 네 - [마츠시게] 무슨…
ああ はい	[시경] 아, 네
こんにちは また ご来店いただいて	[마츠시게] 안녕하세요 항상 감사해요
ありがとうございます	[마츠시게] 감사합니다
カスタードプリンを 食べられるか カスタードプリンを 食べられるか 推薦１ 推薦１	[점원] 커스터드푸딩을 먹거나
北海道 フレッシュクリーム 北海道 フレッシュクリーム 推薦２ 推薦２ 推薦２ どちらかを食べる方が 多いです	홋카이도 프레시 크림 푸딩을 먹는 분이 많아요
こちらの デザートのメニュー	[점원] 그리고 이쪽 디저트 메뉴에는
プリン２種類の 盛り合わせか プリンとケーキの 盛り合わせと なっておりますので	[점원] 푸딩 2종 모둠이나 푸딩과 케이크 모둠입니다
定番 定番っていうのも	- 정석 - [시경] 네
“カスタード” “北海道フレッシュ”	- [마츠시게] - 커스터드푸딩이니까요
北海道フレッシュ クリームプリン	[시경] 홋카이도 프레시 크림 푸딩
これじゃなくて？	[마츠시게] 이거 말고?
“お任せプリン２種 盛り合わせ” とかじゃなくて？	오마카세 푸딩 2종 모둠 같은 거 말고?
どうされます？	- [시경] 아니… - [마츠시게] 오마카세로?
本当？	[시경] 네
いやいや 面白くなるなら	[시경] 그…
考えは ちょっと… はい	[마츠시게] 아니, 그래도… [시경] 네
お任せ２種にします	[점원] 네
かっこいい	- [시경] - [제작진의 웃음]
僕は じゃあ 普通のプリンで	[마츠시게] 그럼… - 그럼 저는 그냥 푸딩이요 - [마츠시게]
はい	- 그럼 저는 그냥 푸딩이요 - [마츠시게]
僕は じゃあ⸺ ホットコーヒーで	- [마츠시게] - [점원] 네
僕もコーヒーで かしこまりました	- [시경] - [점원] 알겠습니다
はい よろしくお願いします	- [마츠시게] 네, 잘 부탁드립니다 - [시경]
うん	응
映画のためですか	[마츠시게] 응
プレッシャーが あったんだと感じました	[마츠시게] 있었어요
60万… ああ ちくしょう	[시경] 60만 좀 넘나?
いや 最近というか…	[마츠시게] 응
ちょっと顔が知られてる 人間の人生って	- [시경] - [마츠시게] 응
僕 22歳⸺	[시경] 저 22살
顔が知られて25年	[시경] 네
ああ 早い	- [시경] 빠르다 - [마츠시게] 그 전부터…
一緒に住み始めたから 同棲(どうせい)して	그렇군요
ああ そうですね	[시경] 아, 그렇군요
もうちょっと やってから	- 그럼 좀… - [시경] 네
ディープな話は ちょっと… はい	- [마츠시게] 응 - [시경] 네
あっ こちらでした ごめんなさい	[점원] 아, 실례했습니다
かぼちゃのプリンです	[마츠시게] 네
何？	[마츠시게] 뭐가요?
こちら 盛り合わせの プリンでございます	[점원] 모둠 푸딩입니다
本日 チョコレートプリンと かぼちゃのプリンです	오늘은 초콜릿 푸딩과 - 호박 푸딩입니다 - [마츠시게] 네
はい	- 호박 푸딩입니다 - [마츠시게] 네
ベイクドチーズケーキが 一緒に のっております	[점원] 베이크드 치즈케이크도 나옵니다
ほら お得よ	[마츠시게] 자랑거리 메뉴죠
あれにしておけば よかった	- [익살스러운 음악] - [마츠시게] 그거 봐
これ食べて… 食べ方は？	이거 먹고…
カラメルと… はい	- [마츠시게] - [시경] 네
うん そうそう やっぱ縦だね	- [마츠시게] 응 - [시경] 이렇게…
ああ	아…
コンビニのプリンとか あれじゃない	[마츠시게] 편의점?
めちゃくちゃ おいしいです	- [뾰로롱 - 효과음] - [마츠시게] 응
うわあ	와
いやあ…	이야
ああ カラメルの香りが いいし	[한국어] 아, 그…
ちょっと焦がしてる味が	- [시경/일본어] - [마츠시게] 응
バニラビーン？ 高級な上品な香り	- [시경] - [마츠시게] 응
栄養たっぷりですか？ ああ もう 牛乳ですからね	[시경] 영양이 풍부해요? 우유라서?
ああ そうそう おいしいですよね あれね	- [편안한 음악] - [마츠시게]
かぼちゃ？	[마츠시게] 응
体に よさそうだよね	[마츠시게] 몸에 좋을 것 같지?
50年以上前ぐらいから あった 韓国は プリンって食べない？	- 와 - [마츠시게]
ジャージーの“ジャ”は 韓国語で“チャ”となる ジャージープリン	[성우] 쟈지푸딩
もち米	[제작진/한국어] 찹쌀
ねじねじ してるんでしょ？ それ クァベギと言います	- [일본어] - [마츠시게의 호응]
それは出来立てが おいしいんです	- [시경] - [마츠시게] 갓 만든 거
うん	[마츠시게] 응
市場の入り口の所で	[마츠시게] 그래
で その皮が もち米なんですよ	[마츠시게] 아!
なんかさ もちもちのやつ食べたね	- [시경] 그걸 튀겨서… - [마츠시게]
それ もち米(チャプサル)ドーナツですよ	[시경] 맞아요 [제작진/한국어] 찹쌀 도넛
いいよ	[마츠시게] 좋아요
いやあ おいしい(マシッタ)	[한국어] 이야
マシッタ おいしい	[시경] 맛있다, '오이시이'
えっ ほんとですか？ うん	- [시경] - 응
やっと褒められた	[마츠시게] 이 사람
うん？	[마츠시게] 응?
テングルテングル はい	[시경/일본어] 네
テングルテングル テングルテングル	- [한국어] - [시경] 탱글탱글
テングルテングリ	- [제작진의 웃음] - [깨달은 탄성]
おお テングルテングル	[일본어] 이거 탱글탱그리
テングルテングリ うん	- [제작진의 웃음] - [깨달은 탄성]
俺ね 俺ね はい	- [마츠시게/일본어] - [시경] 네
ほんとですか？ うん	- [시경] - [마츠시게] 응
日本人の耳からすると	[마츠시게] 응
そうですかね おしゃれな 響きがね	- [시경] - [마츠시게] 세련됐어
そうなんだよね	[시경] 영어 공부해서…
２年ぐらい？ うん	- [시경] - [마츠시게] 응
うん	[마츠시게] 응
そのコラムニストとかが こう⸺	[마츠시게] 응
ビルボードチャート 何週間⸺	- [마츠시게] 응 - [시경]
その歌詞に関して うん	- [시경] - [마츠시게] 아, 응
メッセージが うん	[마츠시게] 응, 응
だから⸺	그래서
たまに しゃべったり してましたけど うん	[마츠시게] 있구나
あの 富士山って 日本人には	[시경] 저기
“一富士 二鷹(たか) 三茄子(なすび)”っていう	[마츠시게] 첫째가 후지산 둘째가 매, 셋째가 가지
言われてるん ですけども	[시경] 네
富士山が見える 見えた？	- [시경/한국어] - [마츠시게/일본어]
すばらしいですよ いやあ もう…	- [마츠시게] - [시경] 정말…
こんな場所で食べて 日が暮れたら	[한국어] 이야
こういうお店 ２人で来て	- [시경/일본어] - [마츠시게] 응
夕焼け 一緒に見て 日が暮れると	- [시경] - [마츠시게] 응
なんか すごい ワクワクするかも	- [마츠시게] 그래? - 아마도요
そうですね	- [시경] 그렇네요 - [마츠시게] 응
“結婚指輪は？”って 言われて	[마츠시게] 응
プリンに入ってたんだ	[시경] 우웩~
もう韓国で…	[마츠시게] 한국에서…
ああ…	아…