미친맛집: 미식가 친구의 맛집 12화 칼국수는 거들 뿐
Subtitle	Human Translation
うん	[마츠시게] 음
ミッチョッタ(やばい) ミッチョッタ	[마츠시게] 미쳤다, 미쳤다
ここは江南の…	[마츠시게] 응
会社って いくらでもあるんで	[마츠시게] 응
へえ	[마츠시게] 그래?
“ハンソンカルグクス”	- [마츠시게] - [시경/일본어] 네
おいしく食べてください	- [마츠시게의 탄성] - [시경]
ハンソンカルグクス はい	- [마츠시게] - [시경] 네
へえ	[마츠시게] 그래?
アンニョンハセヨ	- [시경의 웃음] - [마츠시게]
どうも	[마츠시게/일본어] 안녕하세요
食べてるね	[시경] 네
“模範飲食店” でも こんだけ お客さんがね でも こんだけ お客さんがね	[마츠시게] 근데 이 정도로 손님이 많네
あらっ	그래?
親子３世代で来るんだ	[시경] 네
へえ	그래?
“チヂミ盛り合わせ” “皿盛り蒸し餃子(マンドゥ)” “チヂミ盛り合わせ” “皿盛り蒸し餃子(マンドゥ)” いろんなメニューが ありまして “チヂミ盛り合わせ” “皿盛り蒸し餃子(マンドゥ)” “チヂミ盛り合わせ” “皿盛り蒸し餃子(マンドゥ)” はい	- [시경] - [마츠시게] 응
“カルグクス” ああ １万１０００ウォン “カルグクス” “カルグクス” はい	- [마츠시게] - [시경] 네
それで３５０円	[시경] 그것도 꽤 맛있죠
うん あの⸺	[마츠시게] 응, 저…
魚系 海藻系 あと野菜系	[시경] 그렇죠
ここは牛肉 ブリスケの だしですよ	- [시경] - [마츠시게의 호응]
ちゃんとしてるんだ	[시경] 네
ちゃんと 今日 格好も なんか⸺	[마츠시게] 오늘 우리도 뭔가 제대로…
いつもと違う	평소와 다르잖아
ちゃんとしてるだけ じゃない？	[시경] 정말요?
あの…	[시경] 그게…
スーツは かっこいいんですよ 背広っていうのは	- [마츠시게] - [시경의 호응]
だって毎日 その ジムに行って⸺	[시경] 그럼 유튜브에서?
自分の体の こういうの 見てんでしょ？	- [익살스러운 효과음] - [제작진의 웃음]
鏡 見ないの？ はい	- [마츠시게] - 네
こうやって見て こうしてるんじゃ？ 何でしょう それは	- 이렇게, 이렇게 하면서 - [제작진의 웃음]
アンニョンハセヨ アンニョンハセヨ	[마츠시게] 안녕하세요
お久しぶりです	[시경] 네, 네
いいえ ようこそ	[사장님] 아, 아니에요
注文リスト じゃあ 牛ゆで肉(スユク)の小と 豚肉(チェユク)の小	[한국어] 저희
スユク（小） チェユク（小） じゃあ 牛ゆで肉(スユク)の小と 豚肉(チェユク)の小	- 수육 소짜, 제육 소짜 - [사장님] 네
ナクチポックム タコの辛味炒め(ナクチポックム)に	낙지볶음에 모둠 전 소짜
チヂミ盛り合わせ（小） チヂミ盛り合わせで	낙지볶음에 모둠 전 소짜 - [시경] 이렇게 먹을까요? - [사장님] 네
カルグクスは？ はい	- [시경] 이렇게 먹을까요? - [사장님] 네
いや ここ 面白いのは うん	- [시경] - [마츠시게의 호응]
へえ	진짜?
うん	[마츠시게] 응
うん	음…
スユクです	[사장님/한국어] 수육입니다
うわあ これが最高級なんですよ	- [시경의 탄성] - [일본어]
こっち 牛肉なんだ ゆで牛？	- [마츠시게] - [시경] 네, 네
はい これが豚	- [마츠시게] - [시경] 네, 네 - [시경] - [마츠시게] 돼지고기
豚？	- [시경] - [마츠시게] 돼지고기
これ ポッサム？ とは違う？ うーん こういうものは ただ⸺	- [마츠시게/일본어] - [시경] 음…
チェユク？ うん ポッサムは ポッサムキムチがないと	- [마츠시게] 제육? - [시경] 네
ポッサムキムチは またちょっと違う味	- [시경] - 뭐?
知らないことが 多すぎるなあ	[시경] 그게…
これは このまま	[마츠시게] 응
最初は ここにつけて	- [시경] - [마츠시게] 갑니다
ああ	[마츠시게] 아
うん	음
うん	음
結構 塩分きついね うん	- [마츠시게] - [시경] 네
でも うまみが いっぱい入ってる	[마츠시게] 응
うん うん	- 음 - [시경] 음
はい	[시경] 네
うん	음
うん うん	[마츠시게, 시경] 음
ですよね うん	- [시경] - 응
生にんにくが うん	- [시경] - [마츠시게] 응
こうやって まとめて	[마츠시게] 응
自分が食べます	- [시경] - [마츠시게] 응, 응
“あー”	아~
うん	음
うん	음
ヤンジという 一番 高級な部位で	- [시경] - [마츠시게의 호응]
そうか	- [시경의 웃음] - 그래
あっ	[마츠시게] 어라?
はい	- [시경] 네 - [사장님] 전이에요
エビのチヂミ ズッキーニのチヂミ エビと ズッキーニと エビと ズッキーニと エビと ズッキーニと タラのチヂミ カキのチヂミ タラのチヂミ カキのチヂミ	- 새우랑 애호박이랑 생선 - [마츠시게] 응, 응
タラのチヂミ カキのチヂミ 魚と カキ	- 새우랑 애호박이랑 생선 - [마츠시게] 응, 응 [시경] 굴이 있어요
タラのチヂミ カキのチヂミ	[시경] 굴이 있어요
なかなか ない	[시경] 그렇구나
チヂミの専門店 ないでしょう？ ない ないと思うよ 俺は知らないけど	- [시경] - 없어
ねえ	[마츠시게] 그렇지?
種類が いっぱいある うん	- [시경] - [호응]
エビ	[시경] 네
あっ 単品エビ？ はいはいはい	- [마츠시게] - [시경] 네
うん	음
これ すごいね これ 中⸺	[시경] 네
ほんとにミディアムレア っていうかさ うん	- [시경] - [마츠시게] 응
あの やっぱり⸺	[시경] 그게…
ジョン マスター？	- [두둥 - 효과음] - [시경] 네
これって ジョンの皮っていうのは はい	- [마츠시게] - [시경] 네
ふうん これ カキ？ はい	- [마츠시게] - [시경] 네
これは うまい カキチヂミ	이거 맛있네, 굴전
カキフライとか カキポン酢とか	- [시경] - [마츠시게의 호응]
カキのチヂミ(クルジョン)は韓国の うん	[마츠시게] 응, 응
ノンアルコールビール ですか？ それとも…	[마츠시게] 마시고…
うん	그래
あっ じゃあ 僕の 出しますか？	- [시경] - [마츠시게의 웃음]
はい カムサハムニダ どうぞ	- [한국어] - [일본어]
やっぱり 全然 違う	[시경] 역시 그렇군요
このさあ マッコリが合うっていう 根拠って何だろうね	- [마츠시게] - [시경] 네
この組み合わせが 韓国の味	[마츠시게] 응
お店でしょう？	[마츠시게] 응, 응
ビジネスの相手だったり 親だったり	- [시경] - [호응]
親友だったり	[마츠시게] 응
ああ	아~
韓国料理 苦手っていう 人でも はい	- [마츠시게] - [시경] 네
そうですね カルグクスが…	- [시경] 그렇죠 - [마츠시게]
ええ	아…
へえ	그래?
あらまあ おっきいのが 来ちゃったよ これ	- [일본어] - [사장님/한국어] 네
カルグクスは 半人前ずつに	[시경] 저희 - [시경] - [사장님] 네
はい	- [시경] - [사장님] 네
すぐ覚えればね なんかね うん	[시경] 네
マシッソッスムニダが あるんだね	[시경] 네
マシッスムニダは 今 おいしいです	[마츠시게] 맛있어요
マシッソッスムニダは おいしかったです	- [시경] - 아
マシッソッスムニダって ことね？	'맛있었습니다'처럼?
ああ マシッソッスムニダ	[한국어] '아, 맛있었습니다'
ナッチポックム	- [시경] 네? - [마츠시게] 낙지볶음
ナクチポックム ナッチポックム	- [시경/또박또박하게] 낙지볶음 - [마츠시게] 낙지볶음
ナッチポックム	낙지볶음, 낙지…
ナッチが “ナクチ”	'낙지'예요
ナクチ おっ ナクチ	- 낙, 낙지, 낙지 - 네, 낙지
ナッチポックム	[마츠시게] 낙지볶음
ナクチポックム おっ はい	- 낙지볶음 - 네, 맞아요
食べましょう ナッチポックム	[마츠시게] 낙지볶음
タコ はい	- [마츠시게] - [시경] 네
いやあ このタコは うまい	와
ここの すごさは⸺	- [마츠시게] - [시경] 네
ああ へえ	네
絶妙な火加減	[시경] 이 이상…
かなり達人ですよ これは	[시경] 그러니까요, 네
最高の状態で ここに来たんですよ	- [흥미로운 음악] - [마츠시게] [시경] 네, 그렇네요
難しいじゃないですか	[시경] 그렇죠
うん こう炒める時 はいはい	[마츠시게] 응, 그래
ああ	[마츠시게] 그렇구나
普通は そうめんです うん	- [시경] - [마츠시게의 호응]
それが特徴 うん	[마츠시게] 응, 응
うん	음
うん	음
うん	네
はい	- [마츠시게] - 네
よかった うん	- [시경] - [마츠시게] 응
ふうん うまい	- 음~ - [마츠시게]
そうですね 日本人には	[마츠시게] 응
“辛！”ってなる日本人 結構いると思いますよ	[마츠시게] 있지, 있을 거야
でも僕は大丈夫 ってか おいしい ふうん	- [마츠시게] - [시경의 호응]
うん	[마츠시게] 응
うんうん	네
お肉も	- [흥미로운 음악] - [마츠시게]
“そんな大した味じゃ ないじゃん”って なるかもしれません	[마츠시게] 아니, 그것도… 아니야
ああ ほんとですか？	[마츠시게] 응
もう ボッソボソの	- [마츠시게] - [익살스러운 음악]
バキバキのやつが 出てきても	- [마츠시게] - [익살스러운 음악] [시경] 그래요?
うん	음
よかった うん	- [시경] - 응
作戦？	[시경] 작전요?
はい	[시경] 네
うん ああ	- 음 - [시경] 아
おいしいね(マシンネ)	- [반짝이는 효과음] - [한국어]
うん	[마츠시게] 음
そういう海藻系とか 考えちゃうけど	[시경] 아, 많으니까요
牛肉のスープですよ これは	[마츠시게] 응
その分 だしの香りとか 味わい深さとか	- [마츠시게] - [시경] 네
これは いい	[시경] 잘됐다
うん	[마츠시게] 응
やばい やばい	[시경] 장난 아니죠
ほんとですか？ わあ うれしい	[마츠시게] 응
アイ ラブ ユー	아이 러브 유