미친맛집: 미식가 친구의 맛집 10화 바닷가 1열, 해산물 뷔페 수산시장
Subtitle	Human Translation
ミッチョッタ(やばい)ミッチョッタ	[마츠시게] 미쳤다, 미쳤다
“あっ 韓国人 結構 来てるんだ”と	- [일본어] - [마츠시게의 호응]
「隣の国のグルメイト(ミッチン マッチプ)」 今回は私が生まれ育った 北部九州	- [한국어] - [시경/일본어] 네
福岡出身 福岡出身 そして ここは ちょっと 九州とは ちょっと⸺	[시경] 네
ああ ルーツ的なもの そそりますね けど福岡は飛行機でも １時間もかからないし	[마츠시게] 응, 응
上昇したら 上がったら すぐ降りるだけだからね	[시경] 네, 네
50年以上の歴史がある この下関 唐戸市場	[시경] 네
ええ？	[시경] 에?
ちょっと入ってみます？	[마츠시게] 어
“唐戸市場” いい所だ	[시경/한국어] 이야 너무 좋다, 여기
うれしいです	- [시경/일본어] - [마츠시게] 그렇죠?
これで好きなもん 買ってきなさいって	[시경] 네
ああ そういえば 薬水(ヤッス)市場は	[마츠시게] 약수 시장
甘いもんばかり だったんで	- [시경] - 그랬지
あっ ホドゥクァジャだ	- [경쾌한 음악] - [한국어] 어?
ああ おいしいね(マシンネ)	오
タンチャ タンチャ	[시경/일본어] 네, 단짠…
タンチャン タンチャン	[시경/한국어] 단짠단짠
はい フグです	[시경/일본어] 네, 오
ああ これが？ フグ刺しが 当たるわけじゃないんだ	- [시경] - [점원] 네
１個 やっちゃいます？	- [마츠시게] 꽤 당첨되나? - [시경]
大人２人で 何やってるんだ そうそうそう	- [시경] - 맞아, 맞아, 맞아
買えるのは９時半から	- [한국어] - [시경] 아
９時半から 始まりますって	- [시경/일본어] - [마츠시게] 아!
サラダ巻き？ サラダが入った 変わり種の巻きずし	[시경] 샐러드 마키?
何から いく？ まず	- 저는… - [마츠시게]
光りものも好きですし	- [시경] - [점원] 안녕하세요
どうも すしコーナー すしコーナー	[마츠시게] 안녕하세요, 아
すしコーナー あっ ここは⸺	[마츠시게] 안녕하세요, 아 - 여기는… - [시경의 놀란 탄성]
はあ	[시경] 아
ああ いってみます？	[마츠시게] 아
ああ	[시경] 아!
ねえ 僕あの… 今 二日酔いなんで	- 그러게 - [시경]
二日酔い…	숙취…
酒臭いなと 思ってたんだよ なんか	[시경] 죄송합니다
ああ	[마츠시게] 아!
うん	- [마츠시게] - [점원1] 네
フグ汁 買うって	[점원1] 복어…
ハーイ ハーイ ハーイ 俳優やん	- [점원2] 어? 네 - [마츠시게] 네
ありがとう	- [점원2] 감사합니다 - 감사합니다
名前 何ていうの？	- [점원1] 이름이? - [점원2]
松重 松重豊	[마츠시게] 내 이름? - [점원2] 아! - [점원1] 네?
松重豊さん	[마츠시게] 말해봤자…
そうそう そうそう	- [점원들의 호응] - [마츠시게] 맞아, 맞아
結構 人気あった 昔はね	- [마츠시게] - [점원1의 호응]
今でも あるやない ドラマ 出とるもん	- [점원1] 있어 - [마츠시게] 지금은 없어
知らんやったやん だけん	- [익살스러운 음악] - [일본어]
知っとらな いかんとや	- [익살스러운 효과음] - [점원1의 웃음]
ここで待ってて	[점원2] 들어가, 들어가
うん 見ておいで で ここおいでよ	그럴까?
じゃあ 行く行く	- [마츠시게] 자, 그럼… - [시경]
名前 覚えた？ 名前 覚えた？	[점원1] 네
あの… 田舎に行くと “名前 何だっけ”	- 그렇지? - [시경] [마츠시게] 아!
タコのから揚げ ３００円 ああ	- [마츠시게] - [시경의 호응]
ああ これで１周したね	- [마츠시게] - [시경의 호응]
じゃあ すぐ… あっ スタートした	- [딸랑딸랑 - 종] - [시경]
始まった	[시경] 네
早く選びに行かないと	- [시경] - [활기찬 음악]
スタートです どうぞ 開場	시작합니다, 들어오세요
これ もう じゃあ もう買うことになってる	- [마츠시게] - [점원1] 네
すごいですね	[점원2] 여기 있습니다
シギョンちゃん	[마츠시게] 시경짱
うん	[마츠시게] 응
ありがとうございます	[마츠시게] 고마워요
あの どうしても僕⸺ カニクリームコロッケが 食べたいんです	- [시경] - 아
こんにちは	[점원] 안녕하세요
カニクリームコロッケ はい	- [마츠시게] - [점원] 네
はい	[점원] 네
はい	[점원] 네
はい	[점원] 네
すみません	- [점원] 네, 감사합니다 - [시경] 실례합니다
はい いらっしゃいませ	[점원] 어서 오세요
これで	[점원] 이거요
僕 エンガワ	- [시경] - [점원] 네
はい 両方ください すしと から揚げ２種を購入	[점원] 400엔, 네
覚えてないって絶対 ほぼ覚えてないって	- [마츠시게/웃으며] - [시경의 웃음]
タコ うん	- [시경] 응? - 응
うん うん	- [익살스러운 효과음] - [만족한 탄성]
はいはい 名前 ナンバーワンに なってます	- [점원1] 네, 네 - [시경]
そうそう スープスープ まだあるよ	[사장] 네 [마츠시게] 응
１０００円 ちょうだい	[마츠시게] 고마워요
これも１つ ください	[점원1] 네, 말씀하세요
タルタルソース 付けて	[점원1] 네, 네
タルタル多めで	- [사장의 웃음] - [마츠시게]
カロリーがありますよ 汁物とタラの フライを購入	[사장] 칼로리가 있어요
汁物とタラの フライを購入	[마츠시게] 네, 어…
おかあさん 名前 何でしたっけ 松重さん	[마츠시게] 그래
いや 覚えた 今 人気があるわね	- [점원2] - [점원1] 400엔입니다
今 人気がある？	[시경] 400엔이요
いらっしゃい	[점원2] 어서 와요
やっぱり来てくれた うん	- [일본어] - [마츠시게] 응
そう ありがとうございます	- [마츠시게] - [시경]
ありがとね 危ない危ない お元気で おばちゃん	- [시경] 오, 위험해요 - [점원2] 네
持てなくなってきたね	- [시경] 아! - [마츠시게]
ああ これは いいスープだ	[시경] 아!
これは ほんとに いい景色ですね	[마츠시게] 멋지다
きれいだ 魚は必然的に おいしく なるんじゃないですか？	- [한국어] 되게 예쁘다 - [마츠시게/일본어]
必死に泳がないと うん	- [시경] - [마츠시게] 응
とても いい所だ	[시경/한국어] 야 너무 좋다, 여기
ちょっと混んでるから ２階に用意されてる	- [시경/일본어] - [마츠시게] 응
２階があるんだ はい いいですよ	- [제작진/한국어] 네 - [일본어] 네, 좋아요
乾杯(チャン)	- [시경, 마츠시게] - [제작진의 웃음]
タンチャン タンチャン	[한국어] 단짠단짠
タンチャン タンチャン	- [마츠시게] - [제작진의 웃음]
タンチャン タンチャン	[시경/일본어] 네
で こっちが チャンのほうね チャン	- 네 - [마츠시게]
そうです チャン	[마츠시게] 짠?
まず でも フグですからね これね	- [마츠시게] - [활기찬 음악]
ああ で こんな ピンク色になるんだ	아, 그러면
うん	[시경] 음
うん	- [마츠시게] 음 - 응
うん うまい	- 음 - [마츠시게] 음
ズワイガニの味噌汁 フグ汁が 味噌仕立てだなんて	- [마츠시게] - [시경] 네
あの… 普通に⸺	- [호응] - [마츠시게] 저기
はい	네
はい	[마츠시게] 자
うーん たぶん制作チームは	[시경] 음
おすしの 正しい食べ方とか	[마츠시게] 응
すしは 専門じゃないみたい	- [한국어] - [제작진들의 웃음]
あの… ご飯がさ 醤油につかっちゃうと	그게
ポロポロッと こぼれてくるじゃない？ あれが嫌だから	[시경] 아, 맞아요, 맞아요
そういう場合はネタを こう剥がして	[시경] 음
個人的な見解です	- [마츠시게] - [시경] 응
やってみようかな	- [시경] - [마츠시게] 해봐요
はい うん うん	[시경] 네
うん	[시경] 음
うん うん	- 음 - [시경] 음
うん	[마츠시게] 음
これ ノドグロですよ これ	- [부드러운 음악] - [시경]
ああ やばい	아, 맛있다
ちょっと あぶりました あぶり	- [마츠시게] 아 - [시경의 탄성]
うん うん	- 음 - [시경] 응
ご飯の量が多いよね	- [마츠시게] - [시경의 호응]
ここは面白いな	- [흥미로운 효과음] - [시경/한국어]
おいしいものは おいしいんですよ ですけど ここが⸺	- [시경] - [마츠시게의 호응]
雰囲気？	[마츠시게] 응, 응
市場でバーって ベルが鳴ると	- [활기찬 음악] - [시경]
海峡 見ながら おすし食べるという⸺	[마츠시게] 응
カニクリームコロッケね	- [마츠시게] - [시경] 네
うん ちゃんとカニの 香りもするし	[시경] 응
うん うん	- 음 - [시경] 응
“カニクリーム コロッケだ うん”	- [마츠시게] - [시경의 호응]
うん	[마츠시게] 응
まっちげさんは どうですか？	[마츠시게] 응, 난…
サラダ巻きが 好きだったり	- [시경] 그러네 - [제작진들의 웃음]
そうなんです	[마츠시게] 맞아요
これ おいしい ああ いやあ タルタルは もう…	- [마츠시게] - [시경, 제작진의 호응]
これはね マクドナルドの フィレオフィッシュ みたいな感じ	- [마츠시게] - [시경] 아!
もう人生 一番 好きですよ	- [시경] - [제작진들의 웃음]
ああ	아
そのまま うん	바로 그거지
フィレオフィッシュが？	- [마츠시게] - [시경] 네
スケジュール 始めた	- [제작진의 웃음] - [마츠시게] 아
あんな おいしいものを…	[시경] 이유를 모르겠어요
なぜか分からない	[마츠시게] 맛있는 걸…
硬いですね	- [마츠시게] - [시경의 호응]
あっ これですよ こっちが おいしい	[마츠시게] 아, 이거예요
あっ 本当？ 広告 やろう	그래? 하자!
“止まんないね 最高” “タンチャンタンチャン おいしいよ”みたいな	- [시경의 탄성] - 바나나우유 최고
“タンチャンタンチャン バナナ牛乳”っていう	- [한국어] - [제작진들의 웃음]
ですよね	- 그렇죠? - [마츠시게] 응
何でも やってきたんで 大丈夫	[제작진] 오